1111111111
1P000000C1
1011001101
101C000101
1000110001
1000110001
101000C101
1011001101
1C000000E1
1111111111
