1111111111111111111111111111111111111111
1P0000000000C000000000000000000000000001
1000010000010000000000000000000000000001
100000001000000000000000C000000000000001
1000000010000000001000000000000000000001
1000000010000000000000000000000000000001
1000000010000000000000000000000000000001
100000001000000000000000000000C000000E01
1000000000000000000000000000000000000001
1111111111111111111111111111111111111111
