11111111111111111111
1C0000000000100000C1
10110111111000110111
100100011C1011100001
11011100101000001101
10010001101101111001
10110101000001000011
10000111111111011001
111101010001C1011101
100000010E01010001C1
10111101000100010111
101C0001101101010101
10111011000011100001
1000101101101C111101
10100010001000100001
10101011101110001101
1011100C100011111001
10P11011110110001011
110000000000001000C1
11111111111111111111