111111111111111111111111111111111111111
1C0100000000100000C1C0000001000100000C1
101101111110001101110110111111000110111
100100011C101110010000100011C1011100001
110111001010000011011!11100101000001101
100100011011011110010010001101101111001
101101010000010000110110101000001000011
100001111111110110000000111111111011001
11101101C001C101110111101010001C1011101
100000010101010001C100000010E01010001C1
101111010001000101110111101000100010111
101C000110110101010101C0001101101010101
101110110000111000010111011001011100001
1000101101101C111101000101101101C111101
101000100010001001010100010001000100001
101010111011100011011101011101110001101
1011100C100011111000011100C100011111001
10P110111101100010110C11011110110001011
110000000000001000C110000000000001000C1
111111111111111111111111111111111111111
