1111111111111111111111111111111111111111
1P0000000000C000000000000000000000000001
1000010000010000001111100000000000000001
100000001000000000100000C000000000000001
1000000010000000001000000000000000000001
1000000010000000000000000000000000000001
10000000100000000C0000000000111110000001
100000C01000000000000000000000C010000001
1C00000000000000000000000000000010000001
1111111111111111111111111111111111111111