111111111111111111
110000000011000C11
111001100011100011
101001000010000011
100011110001111111
100011C10000101011
100111111000100111
100001001100100101
100011011110100001
100011001100100001
110111000001110001
110011111111010001
111000000000011001
100000000000001001
111110000000011011
11000P0E0000000011
111111111111111111